20
16
11111111111111111111
10000000000000000001
10000000000000000001
10000000000000000001
10000000000000000001
10000000000000000001
10000000000000000001
10000000000000000001
10000000000000000001
10000000000000000001
10000000000000000001
10000010000000000001
10000000000000000001
12002220021000200001
10000000000000000001
11111111111111111111
