21
19
111111111111111111111
100000000000000000001
101010101010101010101
100000000000000000001
101010101010101010101
100000000000000000001
101010101010101010101
100000000000000000001
101010101010101010101
100000000000000000001
101010101010101010101
100000000000000000001
101010101010101010101
100000000000000000001
101010101212101010101
1022222220s0000000001
101212121212101010101
100022222222222000001
111111111111111111111